 1)$$$$$*****                
   $$$$$*****                 6)       * * * * * 
                                      * * * *                                      
 2)#####*****                        * * * 
   #####*****                       * *
   #####*****                      *
   #####*****
   #####*****
                               7)   *
 3) #*****                           * * 
    ##*****                           * * *
    ###*****                           * * * *
    ####*****                           * * * * *
    #####*****                          * * * * *  
                                       * * * *
 4) #####*                            * * *
    #####**                          * * 
    #####***                        *
    #####****
    #####*****                  8)      * * * * *
                                       * * * * *
 5) *                                 * * * * *
     * *                             * * * * *
      * * *                         * * * * *
        * * * *                 
         * * * * *              9)          * * * * *
                                           * * * * *
                                          * * * * *
                                         * * * * *
                                        * * * * *
                                        * * * * *
                                         * * * * *
                                          * * * * *
                                           * * * * *
                                            * * * * *
                                            
                                            
                                10)   * * * * *
                                        * * * *
                                          * * *
                                            * *
                                              *
                                              *
                                            * * 
                                          * * *
                                        * * * *
                                      * * * * *             